"filename", "language", "CSS", "JavaScript", "HTML", "JavaScript JSX", "JSON", "comment", "blank", "total"
"c:\Users\HP\Documents\e-commerce\e-commerce-ui\generateEmail.js", "JavaScript", 0, 60, 0, 0, 0, 0, 5, 65
"c:\Users\HP\Documents\e-commerce\e-commerce-ui\hh.html", "HTML", 0, 0, 15, 0, 0, 1, 4, 20
"c:\Users\HP\Documents\e-commerce\e-commerce-ui\package-lock.json", "JSON", 0, 0, 0, 0, 37, 0, 0, 37
"c:\Users\HP\Documents\e-commerce\e-commerce-ui\package.json", "JSON", 0, 0, 0, 0, 1, 0, 0, 1
"c:\Users\HP\Documents\e-commerce\e-commerce-ui\public\index.html", "HTML", 0, 0, 0, 0, 0, 2, 0, 2
"c:\Users\HP\Documents\e-commerce\e-commerce-ui\src\App.css", "CSS", 32, 0, 0, 0, 0, 0, 2, 34
"c:\Users\HP\Documents\e-commerce\e-commerce-ui\src\components\about.jsx", "JavaScript JSX", 0, 0, 0, -3, 0, 0, 1, -2
"c:\Users\HP\Documents\e-commerce\e-commerce-ui\src\components\aboutProduct.jsx", "JavaScript JSX", 0, 0, 0, -1, 0, 0, 1, 0
"c:\Users\HP\Documents\e-commerce\e-commerce-ui\src\components\about_pic.jsx", "JavaScript JSX", 0, 0, 0, 0, 0, 0, 1, 1
"c:\Users\HP\Documents\e-commerce\e-commerce-ui\src\components\add_prod.jsx", "JavaScript JSX", 0, 0, 0, 293, 0, 44, 46, 383
"c:\Users\HP\Documents\e-commerce\e-commerce-ui\src\components\cartItem.jsx", "JavaScript JSX", 0, 0, 0, 0, 0, 1, 0, 1
"c:\Users\HP\Documents\e-commerce\e-commerce-ui\src\components\checkout.jsx", "JavaScript JSX", 0, 0, 0, 35, 0, 3, 5, 43
"c:\Users\HP\Documents\e-commerce\e-commerce-ui\src\components\dash.jsx", "JavaScript JSX", 0, 0, 0, 52, 0, -6, 4, 50
"c:\Users\HP\Documents\e-commerce\e-commerce-ui\src\components\delivery.jsx", "JavaScript JSX", 0, 0, 0, 17, 0, 9, 1, 27
"c:\Users\HP\Documents\e-commerce\e-commerce-ui\src\components\discount.jsx", "JavaScript JSX", 0, 0, 0, 45, 0, 3, 14, 62
"c:\Users\HP\Documents\e-commerce\e-commerce-ui\src\components\display.jsx", "JavaScript JSX", 0, 0, 0, -3, 0, 6, 0, 3
"c:\Users\HP\Documents\e-commerce\e-commerce-ui\src\components\exchange.jsx", "JavaScript JSX", 0, 0, 0, 71, 0, 2, 11, 84
"c:\Users\HP\Documents\e-commerce\e-commerce-ui\src\components\filter.jsx", "JavaScript JSX", 0, 0, 0, -19, 0, 29, 0, 10
"c:\Users\HP\Documents\e-commerce\e-commerce-ui\src\components\footer.jsx", "JavaScript JSX", 0, 0, 0, 29, 0, 2, 3, 34
"c:\Users\HP\Documents\e-commerce\e-commerce-ui\src\components\home.jsx", "JavaScript JSX", 0, 0, 0, -3, 0, 5, 1, 3
"c:\Users\HP\Documents\e-commerce\e-commerce-ui\src\components\landing.jsx", "JavaScript JSX", 0, 0, 0, 3, 0, 8, -1, 10
"c:\Users\HP\Documents\e-commerce\e-commerce-ui\src\components\login.jsx", "JavaScript JSX", 0, 0, 0, 2, 0, 2, 1, 5
"c:\Users\HP\Documents\e-commerce\e-commerce-ui\src\components\main.jsx", "JavaScript JSX", 0, 0, 0, 40, 0, 1, 5, 46
"c:\Users\HP\Documents\e-commerce\e-commerce-ui\src\components\modal.jsx", "JavaScript JSX", 0, 0, 0, -4, 0, 0, 1, -3
"c:\Users\HP\Documents\e-commerce\e-commerce-ui\src\components\payment.jsx", "JavaScript JSX", 0, 0, 0, 1, 0, 0, 0, 1
"c:\Users\HP\Documents\e-commerce\e-commerce-ui\src\components\policy.jsx", "JavaScript JSX", 0, 0, 0, 44, 0, 1, 5, 50
"c:\Users\HP\Documents\e-commerce\e-commerce-ui\src\components\prods_admin.jsx", "JavaScript JSX", 0, 0, 0, 81, 0, 23, 13, 117
"c:\Users\HP\Documents\e-commerce\e-commerce-ui\src\components\product.jsx", "JavaScript JSX", 0, 0, 0, -28, 0, 39, -1, 10
"c:\Users\HP\Documents\e-commerce\e-commerce-ui\src\components\productMain.jsx", "JavaScript JSX", 0, 0, 0, 189, 0, 31, 3, 223
"c:\Users\HP\Documents\e-commerce\e-commerce-ui\src\components\products.jsx", "JavaScript JSX", 0, 0, 0, 5, 0, 0, 0, 5
"c:\Users\HP\Documents\e-commerce\e-commerce-ui\src\components\products_admin.jsx", "JavaScript JSX", 0, 0, 0, 7, 0, 0, 0, 7
"c:\Users\HP\Documents\e-commerce\e-commerce-ui\src\components\returnPolicy.jsx", "JavaScript JSX", 0, 0, 0, 140, 0, 1, 4, 145
"c:\Users\HP\Documents\e-commerce\e-commerce-ui\src\components\review.jsx", "JavaScript JSX", 0, 0, 0, 0, 0, 0, 1, 1
"c:\Users\HP\Documents\e-commerce\e-commerce-ui\src\components\shipment.jsx", "JavaScript JSX", 0, 0, 0, 72, 0, 2, 11, 85
"c:\Users\HP\Documents\e-commerce\e-commerce-ui\src\components\sizechart.jsx", "JavaScript JSX", 0, 0, 0, 34, 0, 0, 5, 39
"c:\Users\HP\Documents\e-commerce\e-commerce-ui\src\components\sizes.jsx", "JavaScript JSX", 0, 0, 0, 53, 0, 2, 15, 70
"c:\Users\HP\Documents\e-commerce\e-commerce-ui\src\components\summary.jsx", "JavaScript JSX", 0, 0, 0, 93, 0, 3, 3, 99
"c:\Users\HP\Documents\e-commerce\e-commerce-ui\src\components\tab.jsx", "JavaScript JSX", 0, 0, 0, 25, 0, 0, 3, 28
"c:\Users\HP\Documents\e-commerce\e-commerce-ui\src\components\table.jsx", "JavaScript JSX", 0, 0, 0, 66, 0, 0, 3, 69
"c:\Users\HP\Documents\e-commerce\e-commerce-ui\src\components\tileAlert.jsx", "JavaScript JSX", 0, 0, 0, 1, 0, 0, 0, 1
"c:\Users\HP\Documents\e-commerce\e-commerce-ui\src\components\topNav.jsx", "JavaScript JSX", 0, 0, 0, -4, 0, 10, 1, 7
"c:\Users\HP\Documents\e-commerce\e-commerce-ui\src\components\view.jsx", "JavaScript JSX", 0, 0, 0, 2, 0, 0, 0, 2
"c:\Users\HP\Documents\e-commerce\e-commerce-ui\src\css\add_prod.css", "CSS", 6, 0, 0, 0, 0, 13, 2, 21
"c:\Users\HP\Documents\e-commerce\e-commerce-ui\src\css\dashboard.css", "CSS", -7, 0, 0, 0, 0, 9, 0, 2
"c:\Users\HP\Documents\e-commerce\e-commerce-ui\src\css\delivery.css", "CSS", 10, 0, 0, 0, 0, 0, 1, 11
"c:\Users\HP\Documents\e-commerce\e-commerce-ui\src\css\display.css", "CSS", 7, 0, 0, 0, 0, 4, 0, 11
"c:\Users\HP\Documents\e-commerce\e-commerce-ui\src\css\exchange.css", "CSS", 0, 0, 0, 0, 0, 0, 1, 1
"c:\Users\HP\Documents\e-commerce\e-commerce-ui\src\css\filter.css", "CSS", 1, 0, 0, 0, 0, 0, 0, 1
"c:\Users\HP\Documents\e-commerce\e-commerce-ui\src\css\footer.css", "CSS", 20, 0, 0, 0, 0, 0, 5, 25
"c:\Users\HP\Documents\e-commerce\e-commerce-ui\src\css\header_resp.css", "CSS", 15, 0, 0, 0, 0, 3, 0, 18
"c:\Users\HP\Documents\e-commerce\e-commerce-ui\src\css\login.css", "CSS", -6, 0, 0, 0, 0, 6, 0, 0
"c:\Users\HP\Documents\e-commerce\e-commerce-ui\src\css\modal.css", "CSS", 1, 0, 0, 0, 0, 0, 0, 1
"c:\Users\HP\Documents\e-commerce\e-commerce-ui\src\css\policy.css", "CSS", 53, 0, 0, 0, 0, 2, 10, 65
"c:\Users\HP\Documents\e-commerce\e-commerce-ui\src\css\productMain.css", "CSS", 16, 0, 0, 0, 0, 1, 1, 18
"c:\Users\HP\Documents\e-commerce\e-commerce-ui\src\css\products.css", "CSS", 4, 0, 0, 0, 0, 3, 0, 7
"c:\Users\HP\Documents\e-commerce\e-commerce-ui\src\css\review.css", "CSS", 0, 0, 0, 0, 0, 1, 0, 1
"c:\Users\HP\Documents\e-commerce\e-commerce-ui\src\css\sizes.css", "CSS", 28, 0, 0, 0, 0, 0, 3, 31
"c:\Users\HP\Documents\e-commerce\e-commerce-ui\src\css\sizetable.css", "CSS", 16, 0, 0, 0, 0, 0, 2, 18
"c:\Users\HP\Documents\e-commerce\e-commerce-ui\src\css\success.css", "CSS", -7, 0, 0, 0, 0, 6, 0, -1
"c:\Users\HP\Documents\e-commerce\e-commerce-ui\src\css\summary.css", "CSS", 17, 0, 0, 0, 0, 0, 3, 20
"c:\Users\HP\Documents\e-commerce\e-commerce-ui\src\css\tab.css", "CSS", 14, 0, 0, 0, 0, 2, 1, 17
"c:\Users\HP\Documents\e-commerce\e-commerce-ui\src\css\tablet.css", "CSS", 397, 0, 0, 0, 0, 10, 0, 407
"c:\Users\HP\Documents\e-commerce\e-commerce-ui\src\libs\arraytoObj_sizebased.js", "JavaScript", 0, 9, 0, 0, 0, 0, 2, 11
"c:\Users\HP\Documents\e-commerce\e-commerce-ui\src\libs\calculate.js", "JavaScript", 0, -1, 0, 0, 0, 2, 0, 1
"c:\Users\HP\Documents\e-commerce\e-commerce-ui\src\libs\changeCurrency.js", "JavaScript", 0, 0, 0, 0, 0, 0, -1, -1
"c:\Users\HP\Documents\e-commerce\e-commerce-ui\src\libs\country.js", "JavaScript", 0, 12, 0, 0, 0, 0, 2, 14
"c:\Users\HP\Documents\e-commerce\e-commerce-ui\src\libs\create_discount.js", "JavaScript", 0, 26, 0, 0, 0, 1, 1, 28
"c:\Users\HP\Documents\e-commerce\e-commerce-ui\src\libs\currencies.js", "JavaScript", 0, 10, 0, 0, 0, 0, 1, 11
"c:\Users\HP\Documents\e-commerce\e-commerce-ui\src\libs\deleteUser.js", "JavaScript", 0, 19, 0, 0, 0, 1, 2, 22
"c:\Users\HP\Documents\e-commerce\e-commerce-ui\src\libs\delete_product.js", "JavaScript", 0, 22, 0, 0, 0, 1, 1, 24
"c:\Users\HP\Documents\e-commerce\e-commerce-ui\src\libs\geolocate.js", "JavaScript", 0, 0, 0, 0, 0, 0, 1, 1
"c:\Users\HP\Documents\e-commerce\e-commerce-ui\src\libs\getShipment.js", "JavaScript", 0, 10, 0, 0, 0, 0, 1, 11
"c:\Users\HP\Documents\e-commerce\e-commerce-ui\src\libs\load_image.js", "JavaScript", 0, 5, 0, 0, 0, 0, 0, 5
"c:\Users\HP\Documents\e-commerce\e-commerce-ui\src\libs\modify_exchange.js", "JavaScript", 0, 24, 0, 0, 0, 5, 2, 31
"c:\Users\HP\Documents\e-commerce\e-commerce-ui\src\libs\modify_product.js", "JavaScript", 0, 24, 0, 0, 0, 1, 1, 26
"c:\Users\HP\Documents\e-commerce\e-commerce-ui\src\libs\modify_shipment.js", "JavaScript", 0, 24, 0, 0, 0, 5, 1, 30
"c:\Users\HP\Documents\e-commerce\e-commerce-ui\src\libs\process_product_data.js", "JavaScript", 0, 3, 0, 0, 0, 0, 0, 3
"c:\Users\HP\Documents\e-commerce\e-commerce-ui\src\libs\send_locked_to_be.js", "JavaScript", 0, 2, 0, 0, 0, 0, 0, 2
"c:\Users\HP\Documents\e-commerce\e-commerce-ui\src\libs\suscribe.js", "JavaScript", 0, 10, 0, 0, 0, 0, 1, 11
"c:\Users\HP\Documents\e-commerce\e-commerce-ui\src\libs\uri.js", "JavaScript", 0, 10, 0, 0, 0, 25, 3, 38
"c:\Users\HP\Documents\e-commerce\e-commerce-ui\src\libs\verify_admin.js", "JavaScript", 0, 0, 0, 0, 0, 0, 1, 1
"c:\Users\HP\Documents\e-commerce\e-commerce-ui\src\libs\verify_discount.js", "JavaScript", 0, 10, 0, 0, 0, 0, 1, 11
"c:\Users\HP\Documents\e-commerce\e-commerce-ui\src\socket.js", "JavaScript", 0, 0, 0, 0, 0, 1, 0, 1
"c:\Users\HP\Documents\e-commerce\e-commerce-ui\test.css", "CSS", 50, 0, 0, 0, 0, 3, 9, 62
"c:\Users\HP\Documents\e-commerce\e-commerce-ui\test.html", "HTML", 0, 0, -31, 0, 0, 0, -4, -35
"Total", "-", 667, 279, -16, 1335, 38, 329, 225, 2857